------------------------------------------------                                       -------------------------------------------------
  F1   |  F2   |  F3   |  F4   |  F5   |  F6   |                                       |  F7   |  F8   |  F9   |  F10  |  F11  |  F12  |
------------------------------------------------                                       -------------------------------------------------
   =   |   1   |   2   |   3   |   4   |   5   |                                       |   6   |   7   |   8   |   9   |   0   |   -   |
------------------------------------------------                                       -------------------------------------------------
  Tab  |   q   |   w   |   e   |   r   |   t   |                                       |   y   |   u   |   i   |   o   |   p   |   #   |
------------------------------------------------                                       -------------------------------------------------
 Caps  |   a   |   s   |   d   |   f   |   g   |                                       |   h   |   j   |   k   |   l   |   ;   |   '   |
------------------------------------------------                                       -------------------------------------------------
 Shift |   z   |   x   |   c   |   v   |   b   |                                       |   n   |   m   |   ,   |   .   |   /   | Shift |
------------------------------------------------                                       -------------------------------------------------
       |   `   |   \   | Pg Up | Pg Dn |                                                       | Home  |  End  |   [   |   ]   |
       ---------------------------------                                                       ---------------------------------


                                               |  Esc  | Enter |       |  Alt  | Enter |
                                       |  FN1  | Ctrl  |  Del  |       | Bksp  | Space |  FN2  |